T-X-T-o-B-M-E-T-T-M-B-M-M-M---o-?-o-T-E---|-E-?-o-T-M-E-T-E-X-E-|-T-B-o-----B-o-X-?---X-|-o-M-M---o-X-M-?-T-?-E-----E-?-X-?-o-o-o---o-M-T-|---T-B-T-M-E-T-|-o-o-?-B-M-E-o---|-|-X-|-M-B-|-M---X-T---?--X
|-o-X-B-T-X-X-X-|-T-M-M-|-B-B-?-|-o-B-M-M-B-------|-E-B-M-T-B-E-X-?-X-T-T-?-B-X-M-M-o-X---B-M-|-X-B-?-|-o-T-T-E---T---?-?-B-M---M-B---?-T-M-?---|-T-X---E---X---o-B-E-T-X-E-|-|-X-M-?-|-o-M-E-o-?---M-EM
B-?-o-X-M-X---T-M-|-M-|-X---o-M-X-T-T-E-M-?-M-?-B-X-T-T-B-?-o-?-?-M-|-o-M-E-E-?-o-----?-M---M-?-o-|-B-T---?-X-E-M-E-X---X-B-E-|-o-B---?-?-?-|---T-o---B-M-T-?-E-X-?---E-|-X---E---E-T-o-M-|-T-B-T-X-o-EX
o-?-X-X-B-?-B-T-T-B-o---E-B-o-|-o-o-|-T---M-|-M---?-T---o-X-E-o-T---E-M-M---X-X-|-B---M-X---|-X-E-X-o-M-T-?-o---E-X-B-E-o-?-T-?-T-?-o-?-?-B-o-X-?-o-|-T-E-|-T-o-X-|-|-T-B-o-X-M-o-B-T-M-T-M-|-o---o-X-Bo
|-B-|-M---|-|---o-E-B-o-?-?---X-B-T-X-B-E-?-X-o-o-E-X-M-E-M-?-M-B---M-B-B-?---T---o-T-|-B-X-T-B---B-|---E-|-M---o-E-?-X-|-|-E-X-|-o-|-T-M-|-M-X-|-|-?-B-X-?-T-?---o---|-|-E-?-E---B-|-o-M-o-o-X-B---?-XE
B-E-o-|-X-?-X-E-M-?-E-|-B-E---T-X-o-B-E-?-X-M-?-?-?-----?-?-M-o-E-o-------B-o-T-|-T-?-X-B-T-o-B-B-E-|---X-|-o-X-E-T-M-X-|-B-B-T-o-?-|-?-E-M-|-----M-T-?-X-B-X-?-E-X-X-|---o-E-X-?-o-o-B-E-T-B---?-o-T--?
E-o-|-X-E-X-X-B-T-E-T-o-M-E-E-|-?-E-?---E-X-E-X-T---o-|---|-?-|-B-o-B-T-E-o-E-T-X-|-M-T-E-E-X-M-T-M-X-E-E---?-E-E-E-|---B---X-o-X-T-T-E-o-|-E-|-T-M-X-o-M-|-E-B-X-o-|-?---B-B-X-o-E-M-T---E-B-M-M-?-M-M|
T-M---T-?-X-o-E-X-T-X-M-?-X-B-E---?-T-E-o-o-M---T-B-|-X-E-?-B-T-?-X-B-?---X-X-?-|-o-E-o-B-?-B-T-o-E-T-B-E-|-M-o-T-|-E-X-M-?-|-o-----?-?-?-M-T-|-o-X-X-T-|-X-|-M-|-?-X-|-E-B-o-B-B-?-B-E-o-T-X-?-T---T-Mv
o-----|-M-M-|-M-o-o-?-E-M-|-|-E-B-T-T-M-M-T-T-------o-B-M-E---o---X-T-?-T-X-X-o---M-X-|-o-?-E-E-o-|-?-?-M---M-|-E-E-M-M---B-o---X-|-E-M-E-E-X-M-X-|---M-|-?---B-B-?-|-X-?-E-|-B-B-?-M-T-?---o-|-T-o-o-EE
E-B-T-?-E-E-?---T-M-T-?-X-E-B-X-X-E-B-|-M-B-?-B-?-B---M-|-E-B-X-M-E-X---E-T-E-M-?-T-o-M-B-B-|-|-X-o-T-T-|---X-M-M-B-|-X-?-M-|-M-T-B-|-o-T-X-T-|-B-M-M-E-o-B-X-E---M-B-|-M-o-E-B-X-E-?-M-E---M-B---E---|E
M-M-X-E-X-E-B-|-|-X-T-B-X-M-|-B-M-X-E-o-M-E-T-|---?---E-M-?-o-T-X-M-X-|-B-B-M-X-o-o-o-M-----X-|-B-M-E-X-|---B-X-M-?-X-M-?-|---?-M---E-o-B-B-E-?-B-----|-E-?-X-T-o-?-?-M-o-E-T---X-M-X-M-o-|-o-X-M-E-o-oM
M-T-M-o-X-E-?-X-|-o-o-?-|-B-?-T-?-X---M-?-o-E-T-X-B-o-?-o-T-X-|-T---E-E-M-B-?-E---o-------T-B-?-|-T-M-?-o---M-M-?-X-M-X---T-o-|-E-T-E-o-o-M-E-X-E-X-B-E-M-M-X-E-E-o-E---X-X---M-T-?-T---o-B-B-X-|-M-o-BM
o-M-E-?-T-M-B-M-M-E-E-?-M-E-M-X-M-M---|-?-o-T---?-?-|-o-?-B-X-|-E-T-E-E-?-|-B-?-o-T-B-E-B-X-o-o-o-E-M-T---E-E-|-?-E-E---o-B---T-M-?-o-M-B-?-M-B-|-T-B-B-X-T-T-?-X-E-o-B-B-X-B---T-|-M-o-X-|-T-T-E-E-T-o-
?-B-B-X-|-B-B-E-X-M-M-X-o-|-E-?-|-B-B-o-E-o-T-|-o-E-M-T---B-M-T-o-?-B-X-?---B-B-X-M-?-T-T-M-E-|-o-o-E-X-X---?-T-|-|-X-M-?---?-M-M-M-o-M-E-T-B-?-X---?-E-T-X-M-E---|-X-M-|-?-E-|-E-|-E-T-|-T-?-B-T-o---TT
m-E-?-?-B-o-M-M-o-|-X-E-M-o---|-?-M-T-M-o-|-?-M---M-M-E-E-M-M---T-X-E-E-E-?-M-T---o-B-T-B-M-|-E-X-?-M-M-?-E-|---T---?-o-B-X-|-X-E-E-E-T-B-|---M-X-E-T-B-X-?-|-o-M-E-T-T-X-E---B-o---|-B-?---E-B-o-o-o-EX
XXXXXXXXXXXXXXXXXXXXXXXXXXXXXXXXXXXXXXXXXXXXXXXXXXXXXXXXXXXXXXXXXXXXXXXXXXXXXXXXXXXXXXXXXXXXXXXXXXXXXXXXXXXXXXXXXXXXXXXXXXXXXXXXXXXXXXXXXXXXXXXXXXXXXXXXXXXXXXXXXXXXXXXXXXXXXXXXXXXXXXXXXXXXXXXXXXXXXXXX
