T-?-o-M-B-?-|-?---B-E-o-|-B-o-o-M-o-M-?-|-M-B-X-X-M-o-M-----o-o-?-?-X-|-?-E-M-o-X-?-E-|-M-|-B-|-o-T-o---o-E-E-?-|-M-o-E-?-M-B-?-X-|-?-?-X-|-?-X-B-M-X-M-X-o-B-o-o-X-M-T-X-T-T-?-|---o-T-o-M-?-?---o---|o
|-T-X-T-?-o-o-o-B-|-E-M-B---|-X-E-M-B-B-M-X-E-E-?---B-X-B-M-|-?-M-o-E-E---T-B-E-E-M-|-X-B-M---X-E-E-B-B-X-|-T-?-----M-B---o-?-T-?-o-|-X-o-M-T-|---T-M-X-T---?-X-T-B-X-E-E-M-X-B-X---?-E-T-M-X-M-T-|-B-Xo
T-T---o-?-T---T-B-M-X-X-T-?-X-T-o-X-E-B-X-o-B-B-E-?-X-T-|-E-o-B-o-M-B-|-|-o-----T-T-X---T---B---o-X-M-M-o-E-M-?---B-o-T-B-M---o-?---E-T-|-X-M-?-T-|-T-?-T-|-?-X-M-E-o-E-------B-|-B-E-T-M-X-X-M---E-o-BB
?-B-o-o-T-B-|-M-o---|-----B-T-B-M-X-M-T-o-M-M-o-E-E-X-B-M-?-X-E-E-|-?-T-o-X---T-E-E-T-o-?-T-o-o---B-M-o-|---E-T-?-?-?-o-T-----o-X---?-|---E-X-M-?-?-o-X-o---o-E-M-X-E-B-X-E-?-o-|---X-X-----|-?-X---M-B-
B-|-E---o-o---X-?-B-E-o-o-M-M-T-E-X-|-M-X-E-o-?-E-?-o-o-T-o-T-B-M-T-M-E-?-o-X-?-o---?-M---M-o---T-o-|-|-X---?-|-B-?-B-X-E-X-B-B-X---M-----?---E-B---E-o-|-M-o-|---?-o-T-X-X-|-E-?-o-M-B-T-E-X-B-M-M-M-|M
?-T-?-X-?-E-o-T-T-|-B-o-T-E-----X---E-X-B-T-?-M-?-X-T-T-|-E-o-E-|-?-X-?-X-|---?-E-B-o---X---M-E-B-M-E-o-T---|-X---|-T-|-X-o-B---o-X-T-E---?-E-T-?-E-B-o-B-T-o-T-T-T-T-o-E-E-|-B-|-E-|-E-M-X-|-E-|-B---XX
B-M---o-T-|-E-T-o-?-|-T-T-|---o-T---B-M-B---T-?-|-X-B-M-X-E---M-M-M-M-o-?-E-T-X-?-B-E-o-|-B-B-o-T-M-o-T-|---|-T-M-B-T-|-?-?-T-?-X-?-E-E-?-E-M-T---E-E-E-E-?-o-?-T-X---?-?-o-M-----|-M-B-----E-E-B-----TT
?-E-M-o-?-X---E-X-|-X-|-B-?-o-?-?-M-B-B-X-E-o-B-o-B-E-B-o-?-B-B-T-X-B-X-E-T-B-X-|-M-T-?-B-o-|-o-B-E-X-T-B-|---E-T-|-|-E-E-E-B-?-----B-M-o-|-E-B---?-M-|-?-X-o-M-T-M-T-|-B-B-------B-M-|-M-E-B-?-?-M-T-Tv
o-X-M-T-?-o-|-E-?-X-?-B-B-X-?-T-T-B-X-?-B-|-M-M-M-M-o-?-?-M-o-E---X-?-M-?-T-X-X-?---T-X-B-T-X-M-T---|-M-T-|-T-E-?-o-o-X-M-M-B-E-M-?-|-?-X-?-E-X-M-?-|-o-E-o-X-?-|-M-X-|-T-B-o-|-?-X-B-|-E-B---|-T-M-o-oB
o-o-|-M-T-|-X-B-o-E-B-M-T-E-|-B-o---E-X-B---?-M-o-B-?-o-T-T---E-X-|-?-B-?-M-|-|-T-E-M-o-M-T-o-o-M-E-M-X-E-T-o-M-M-E-M---X-|-|-E-|-E-|-o-o-M---B-?-o-?-B-o---|-T-B-E---E-T-E-|-T-M-?-o-B-M---o-|-?-o---T?
|-T-B-|-|-X-E-?-X---?-M-o-X-----E-E-T-T-B---?-X-----|-B-E-E-T-X-T-X-|-----E-T-M-o-o---|-----X-|-B-M---B-E-E-?-E---M-T-X-B-M-E-T---?-E-T-o-?-M-X-E---?-E-B-B-?-----B---M-T-E-B-E-o-T---T-X-X-X-o-X-|-?--M
X-o-B---|-M-X-T-E-?-|-E-M-|-o-?-B-B-B-X-T-B---o-M-?-E-T-o---B-B-M-M-B-|-?-B-M-X-T-X---|-X-|---X-?---o-M-X-E-E-o-B-|-?-B-E-X-E---B-B-M-B---M-M-?-o-?-?-E-X-?-T-|-E-?-X-|-X-|-X-B-E-X-T-M-X---X-B-M-E---MB
E-E-|-B-o-E-M-M-X-E-o-T-T-o-M-o-o-?-X-|-|-?-|---M-T-X-?-X-B-o-E---o-B-X-T-o-o-T-o-o-E-----X-E-X-X-E-B-E-o-|-X---?-E---|-E---T-o-T-E-|-?-?-B-o-?-T-|-o-X-T-E-|-|---X-|---X-E-X-E-T-B-X-B-?-T-E-o-B-----?E
o-?-o-B---M-M-?-X-T-X-E-o-M-?---|---o-X-o-?-T---o-?-B-E---T---?-?-E-?-M-M---T-E-T-T-|-?-X-X-?-X-M-|-M-|-B-T-?---?-E-o-B-T---M-B-X-E-?-B-----o-M-B-B-?-X-B-o-|-|---o-o-E-?-M-|---B-----?-o-o-X---E-T-M--T
m-----E-E---|-E-E-T-E-?-X-o-T-T-X-M-M-X---X---|-?-?-E-?-E-----X-E-X-E-X---|-?-M-?-|-|---X-M-E-B-M-|-o-X-B-T-o-?-o-?---E-?---B-B-X---M-E-?---E-E-T-X-E-M---?-B-T-B-?---E-|-T-M-E-M---|---B-|-B-M-X-T---M?
XXXXXXXXXXXXXXXXXXXXXXXXXXXXXXXXXXXXXXXXXXXXXXXXXXXXXXXXXXXXXXXXXXXXXXXXXXXXXXXXXXXXXXXXXXXXXXXXXXXXXXXXXXXXXXXXXXXXXXXXXXXXXXXXXXXXXXXXXXXXXXXXXXXXXXXXXXXXXXXXXXXXXXXXXXXXXXXXXXXXXXXXXXXXXXXXXXXXXXXX
