o-|-?-o-|-X-M-M-E-|-E-o-B-B-B-X-B-E---E-E---?-M-?-M-?---M-M-B-B-T---?-T-B-E-M---M-M---E-T-E-o-X-o-?-|-B-|-M-E-E-?-X-T-|-?-X-M-X-B-E-E-T-M-M-T-T-X-|-B---o-X-B-E---B-o-|-?-T-T-|-X-X-|-M-?-B-B---M-o---?|
|-B-?-B-o-B---?-B---B-B-B-X-T-?-T-E---o-|-T-?-X-?---B-X-B-E---X-E-o-M-X-B-?-M-M-M-M---T-X-M-|---X-B-M-T---?-|-X-|-?-E---o-E-E-B-|-|-o-X-M-E-o-|-o-B-E-|-X-o-|-E-T-?-T-|-B-?-|-T-|-B-X-B-o-|-T-E---o-B-EM
|-T---E-X-----B-M-|-|-X-|-X-?-?-E-?-X-E---o-X-o-o-X-M-E---B-|-B-B-?---|-E-T-B-E-E---o-o---?-M---T-E-T-?-E-?-X-E-B---X-E-|-M-X-M---X-?-T-|-?---?-E-M-?-|-|-B-X-o-M-o-M-?-T-|-T-B-X-M-?-T-T-M-M-X-T-|-B-o?
M-X-?-?-B-X-o-|-M-o-T-B-o-E-M-X-M-o-?-|-T-B-M-o---T-X-?-E-T-o---o-T-E-o-M---E-B-X---o---X---M-o-?-?-o-?-o-M-M---|-?-o---|-B-|-?-|-|-|---E-B-o-M-X-?-B-X-E-?-?-M-X-T-T-E---?-o-o-M-T-|-B-?-X-X-?-o-B-?-Xo
B---M-T-o-T-?-X-M-o-o-o---|-E-X-o-o-?-X-M-X-M-|-X---B-?-E-B-T-E-E-T-o-|-B-|-E-|-T-o-T-E-T-?-|---X-X-?-X-?-M-|-B-E-B-E---o-T-o-E-?-|-X-X-|-E-o-M-E-E-T-|-B-T-?-T-|-|-o-?---T-?-o-M-M-M-B-E-X-o-o-M-E-T-ET
--M-B-B-T-M-M-|---B-T-M-|-|-?-M-B-?-T-|-|---o-?-B-M-X-X-M---M-X-X-E---|-------|-X-|-?-o-M-B-X-|-T---T-o-?-M-T-T-M-E-T-T-o-E-X-E-B-E-X-?-T-M-o-o---M---B-B-|-o---M-X-o-E-?-M-|-B-X-?---E-o-B-X-E-E-X-|-TM
o-o-T-X-B-X-T-----o-M-o-T---?---M-M-B-X-M-?-E-X-X-o-B-B-o-?---M---M-E-o-X-|-T-E-|-M-B---|-M-o---B-?-T-o-B-?-?-T---X-?-|---o-o-B-M-M-|-M-E-X-|-|-B-?---o-|-M-M-X-X-M-E-o-?-o-M---|-M-?-B-o-|-?-E-o-?-M-|E
E-M-B-T-?-o-|-X-E-o-|-o-X-X---E---M-|-?-E-X-|---o-|-M-X-E-E-T-|---o-|-M-|-B-?-B-E-E---M-----X-B-B-M-B-?-B-X-M-B-|-?-B-|-B-?-X-X-|-X-B-M-|-B-o-X-?-T-T-o-o-o-?-B-o-X-o-o---o---|-E-X-T-M-|-T-|-?-B-?-X-Xv
B-X-o-|-B-M-M-|---X---X-o---X-|---X-o-E-o-X-T-B-?-E-M-B-T-?-M-o-E-M-B-X-B-B-?-?-?-|-M-|-T-E-----X-?-?---o---T---|---X-?-o-X---M-o-?-B-?-?---E-B-M-B-B-o-|-|-B-B---X-?-E-M-B---?-E-M-M-X-E-T-|-T-?-o-T-EE
B-M-T-E-o-B-X---T-?-o-X-M-o-X-o---X-o-X-B-o-|-?-E-T---|-T-T-o-?-o-o-X-o-?-M-E---|-?-M-E-M-B-B-T---o-|-|-|-B-B-B-T-o-T---?-T-|-X-M-|-X-E-M-|-E---E-B-B-B-?---?-?---M-?---X-T-M-B-?-E-o-?-E-B-|-M-o-M-E--T
|-o---X-M-B-X-M-X-M-B-T-?-|-X-X-X-X-B-M-E-?-B-E-E-|-|-B-B-X-o-o-M-?-E-?-o-?-B-M-o-T-B---X---T-B-o-|-M-o-?-M---|-o-M-T-?-M---o-o-E---M-?-X-E-T-?-M-o-|-|-E-E-X---B-E-M-X-B-T-T-B---M-X-E-?---E-M-|-?-M-|?
E-?-M-X---X-|-o-B-X-o-o-?-B-T-E-B-|-T-T-M-B-o-B-|-E-T-M-?-|-T-M-B-o-o---E-?---M-o-B-M-o-|-?---|-?-M-E-M-o-M-|-B-|-o-M-M-E-|-?---B-?---|-X-B-?-M---X-X-T-|---o-E-E-E-?-|-X-?-M-M-M-M-?-T-B-o-E---B-T---M-
X-|-M-M-M-M-|-B-M-T-|-M-B-M-M-|-|---o-X-M-M-?-?-T-o-E-T-|-|-|-T---B-E-M---E-?-T-|-|-E-T-|-T-M-X-T-B-B-T-B-M-o-o-E-B-T-E-B-o-X-?-M-?-?-?-o-X-T-B-?-?-X-T-B---T-T-|-X-|-B-E-B-M-T---T-?-o-B-?-?-E-B---|-oT
|-o-E-T-M-?-o-M-B---X-o-X---X-?-E-----B-M-E-o-o-B-?-T-|-E-B-X-T-----?-B-X-X-X-B-E-|-?-o---T-M-M-X-E-X---B---E-X-X-M-M-|-E-T-M-T-o-|-o-E-B---T-?-o---M-M-E-X-?-o-X-----T-E-T-E-X-|---T-?---X-E-M-B-o-B-T|
m-M---o-B-----?-B-o-T-E-?-o---X-o-T-M-B-|-o-|-T-X-B-M-B-E-B-E-E-B-|-?-T-----M-E-X-M-|-M-X-B---X-|---o-o-?-E-|-----?---E---E-----X-M-o---?-E-X-?-X-M-o-?-E-T---o-|-?-T-o---T-E---o-E-|-|-----X---T-E-T-Xo
XXXXXXXXXXXXXXXXXXXXXXXXXXXXXXXXXXXXXXXXXXXXXXXXXXXXXXXXXXXXXXXXXXXXXXXXXXXXXXXXXXXXXXXXXXXXXXXXXXXXXXXXXXXXXXXXXXXXXXXXXXXXXXXXXXXXXXXXXXXXXXXXXXXXXXXXXXXXXXXXXXXXXXXXXXXXXXXXXXXXXXXXXXXXXXXXXXXXXXXX
