?-E-B-X-o-o-----|-B-|-?-B-|-?---?-X---|-E-o-?-o-B-X-?-|-M-o-o-|---T-B-X-o-B-o-?-o-B-B-?-E-T-B-B-----o-T-|-T-B-o-o-o-|-|-|-|-B-E-M-M-T---E-E-o-?-?-T-X-|-X-T-----?-T-o-o-----T-o-|-B-M-B-|-o-T-M---B-|--X
--X-X-B-T-M-X---M---T-?-X-B-o-E-M-E-|-E-B-T-E-T-|-T-o-B---o-X-T-X-M-X-B-X-T-o-M-X-M-|-T-E-T-?-o-?-M-B---X-M---X-B-?-M-B-B-B-M---M-|-o-X-M-?-?-E-X-T-T-E-E-o-T-o---|-|-|-M-B-M-M-B-o-X-?---T-o-M-E-o-o-EX
B-T-|-|-o-M-B-T-E-|-E-o-B-E-|-B-?-T-E-M-E-|-T-T-M-|-|---o-M-B-E-M-M-|-M-o-M-o-M-E-E-T-E-B-?-|-?-|-E-E-o-B---X-E---?-E-?-B-|-E---E-|-o-E-M-M-o-|-E-M---T-B-E-M-o---?-E-T---o-|-T-o-T-B---M-B-o-X-?-o-X-o?
E-o-?-E-|-M-?-?-|-?-|-X---|-T-|-?-|---M-B-X-T-T-E-T-X-|-o-o-T-B-B-X-|-M---o-B-o-|-|-E-B-o-T-B---X-X-B-T-X-X-E-X-?-o-?-|-|-M-M-o-T-|-E-T-?-T-|-B-B-B-B-T-T-?-T-X-?-T-X-|-?-o-M-X-|-M-B-o-M-?-E-?-X-E-X-B?
T-M-M-B-|-|-M-T-E-o-T-B-T-E-B-E-M-X-B-X-X-X-?-E-o-B-X---T-?-B---X-B-T-?-M---M-B-|-E-B---|-T-?---o-?-T-?-|-B-E-----E-B-T-M-o-?-X-B-|-T-B-X-E-|-E-|-|-M-?-X-M-|-B-M-M-E-T-B-B-?-|-E-X-o-X-X---B-T-T-T-E-Xo
B-T-?-?-E-T-M-o-T---X-o-X-X-T-T-|-X-B-B-M-|-B-E-E-E---T-X-X-o-?-?-?-E-T-|---B-|-B-|-M-?-B---|-E-?---o-X-|-|-?-|-o-M-E-T-?-|-o-|-T-|-X-M-X---T-B-E-|-o-o-o-X-E-X-|-T-T-----T-E-M-M-B-T-T-X-|-o-X-X-|-X-|-
E-|-M-E-o-|-?-|-T-|-T-?-o-X-|-|-E-?-B---X-?-o-M-T-X-|-?-|-?-M-E-T-M---|-o-?-o-E-o---T-E-E-?---X-M-o-o-M-T-X-M---X-o-T-?-B-X-o-B-M---o-X-|-M-B-T-o-E-M-B-T-E-o-B-?-T-B---o-E-E-M-|-T-|-B-?-T---M-B-o-?-TT
B---T---o-o-?-B-X-o-o-?-?-T-T---T-M-o-M-E-E---|-o-B-|-T-?-o-M-M-B---B-E-B-B-M-T-?-T-T-?-X-E-o-|-E-B-T-o-M---o-M-E-E-?-?-T-?-|-T---B-?-?-M-|---T---|-E-?-E-B-|-M-----E-o-T-B-?-B-M-T-B-B-M-X-o-o-?-T-o-ov
B-B-B-o-B-|-?-T-B-E-X-|-X-|-o---o-?-X-T-E-M-T-B---B-|-|-M-o-X-o-?-X-B-B-?-M-B-M-T-o-|-E---M-T-?-M-?-E-E-E-o-|-B-M---M-o-o-?-T-B---X-M-T-o-o-M-B-----B-X-B-B-B-M-o-T-?-o-E-M-T-E-?-?-o-B-o-M-X-X-B-|-|-ET
o-B-X---?-B-o-o-T-o-|-E-M-X-|-?-|-----?-E---B-E-E-o-|-T-?-T-E-?-|-?-E-|-?-?-M-o---B-M-B---|-o-E---T-E-X-M-o-|-|-M-M-|-T-T-------o-M-|-o-T-M-E---o-X-B-E-?-?-|-X-T-E-o-M-E---E-B-E---X-X-B-?-B-o-o-o-T--M
E-E-B-M-M-T-B-M-E-|-o-E---B-|-?-o-E-o-o-E-T-M-E-o-|-?-B---X---o-X-|-?---?---M-----?-|-|---E-o-B-T-X-B-|-E-T-M-X---B-o-M---o-B-X-E-E-B-E-M-T-T-|-B---|-E-M-|-o-|-M-B-?---o-X---T-M---M-B-?-|-|-o-E---?-B?
o-B-M-|-o-?-X---E-X-X-X-o-o-E---X-B-|-?-o-X-E-X-B-M---o-T-T-M-M-B---|-E-B-X-|-T-T---T-o-E-o-?-B-T-|-o-X-o-E-B-B-B-?-|-o-|-o-T-E-M-T-B-E-T-B-|---E-|---X-B-o-T-B-B-E-o-o-o-|-X---?-|---o-M-|-E-M-M-T-B-X?
o-X-----o-T-M-X-|-E-?-E-|-?-|-|-o---X-|-|-?-X-E-|-|-E---B-o-B-M-|-X-o-B-X-E---o-B-|-T-X-?---o-M-|-X-B-T-X-E-B-M---M---M-E-o-|-M-M-B-T-|-X-M-B-T-T-o-X-X-M-T-E---|-o-M-X-X-T---M-o-X-T-M-?-X-?-X-----M-|o
E-T---M-X-o-T-T-o-|-B-?-|-o-B-E-T-E-X-o-o-E-|-E-?-B-X-T-M---B-o-X-B-X-M-T-M-X-o---M-?-T-E-X-M-?-X-----T-o-B-B-o-T-----B-B-E-o-X-o-T-X-----|-|-E-E---E-M-o-o-M-T-T-?-?-T-X-T-X-X-B-E-B-|-----|-|---?-T-T-
m-M---E-X-T-o-----X-X-o-M-E-B-o-|---T-o-|-T-|---M-E-M-M-M-M-?-E-?---B-M-o-M-B---B-o-----B-o-B-B-o-X---M-|-|-M---?-o-X-|-?-M-?-o-M-|-o-B-?-o-M-B-----M-|-E-M-|-T-o-?-|-|-X---o-o-T-B-M-E-|-?-E-X-B---?-EE
XXXXXXXXXXXXXXXXXXXXXXXXXXXXXXXXXXXXXXXXXXXXXXXXXXXXXXXXXXXXXXXXXXXXXXXXXXXXXXXXXXXXXXXXXXXXXXXXXXXXXXXXXXXXXXXXXXXXXXXXXXXXXXXXXXXXXXXXXXXXXXXXXXXXXXXXXXXXXXXXXXXXXXXXXXXXXXXXXXXXXXXXXXXXXXXXXXXXXXXX
