?-M-X-o-o-o-B-B-|-|-T-E-X-|-X---T-T-|-X-|-X-M-?-E-X-?-|-T-X-E-X-M-X---M-T-o---?-E-B-o-B-|-M-T-M-|-B-?-|-E-T-T---?-?-X-X-M---o-o---o-B-M-X-?-T-M-T-----|-X-o-B-E-X-T-E-?-|-o-?-T-?-M-T-B-M-E-T-|-B-B-X-o|
B-E-o-?---E-B-B-T-o-M-?-|-?-X-T-|-?-B-?---o-B-o-B-B-|---M-X-X-M-B-o---?-X-E-|---o-E-B-X-T-X-o---|-T-B-?-o---E-B-B-X-T-B-X-E---o-X-E-E-X-o-M-M-T-B-E-B-X-M-E-|-E-M-M-?-M-o-o-|-E-|-M-M-M-?-M-M-X-|-?-B-ET
T-|-B-M-|-o-o-?-E-|-X-M-?-B---X-?---|-E-E-B-?-T-B-?-o-o-o-|-X-|-?-X-E-o-B-E-M-?-o-E-----?-B-T-|---B-B-M-T---M-T-?-o-?-o-T-o---o-o-----T-B---E-|-T-E-?-?-X-B-M-B-B-B-X-T-X-X-B-M-o-----?-?-|-M-X-X-X-E-E?
?-|-T-T-T-B-T-?-X-M-|-|-B-T-|-?-o-M-X-M---T-M-X-?-X-T---X-M-o-X-|-M-M-X-T-B-M-E-?---M-M-X---B-M-T-T-|-o-T-|-o-B-B-?-|-B-?-E-E---X---X-o-|-X-B-o-o-B-?-?-M-o-M-E-T-X-o-E-M---T-|-X-?-?---B-E-B---M-X-M---
T---?-o-X-|-o---M-|-T-M-|---E---X-M-M-E-X-E-?-M-M-?-T-T-?-E-|---B-T-M---o-X-o-T-X-M-o-o-B-E-?-X-T-M-?-M-M-E-E-E-T-?-B---o-B-B-E---E-o-?-T-o-o-M-o-T-o-B-|-o-E---o-o-?-o---T---E---B-T-o-B-E-T-?-T-X-X-T?
--|-E---X-X-B-X-M-o-B---|-X-T-E-M-M-B-|-?-|---B-o-T-M-M-X-|-?-M-M-E-o-T-T-|-|-X-o-X---B-B-B-o-|-B-M-M-B-X-E---o-T-B-E---B-o-|-|-B-B-T-o-M-E-?-X-o-o-?-T-|---T-E-|-|-X-?-M-X-X---M-?-o-?-X-T-M-M-o---X--E
T-M-M-B-E-E-T-T-o-?---o-T-o---|-?-B-o-T-T-|-X-o-B-B-?-?-o---E-E-E-o---B-|-o-o-?-B-T-X-T-X-E-|-|-X-o-M-o-B-|-E-o-M---o-X-o-?---M-E-B-X---?-?-o-|-X-|-B-M-M---T-|-E-o-o-T-E-B-M-T---E-|-B---|-X-X-|-o---?o
B-o-B-B-E-B-B-B-?-E-M-?-E-M-B-?-E---E-o-B-?-T-o---T-T---E-T---?-T-B-X-?-E-o-o-|-X---E-E---o-?-o-X-T---M-B-E---B-|-M-|-X---E-X-E-?---B-E-B-E-E-?---|-E-?-X-o---E-B-M---|-E-X-T-E-B-----?-M-o-B-E-?---?-Tv
E-o-?-T-|-|-E-X-B-M-T-E-|-o-o-------|-B-|-M-|-?-X-B-o-M-E-M-?-----B-X-X-o-X-T-|-|-|-B-----o-o-o-E-E-M-o-X-E-|-B-X-E-X-o---B-?-?-o-T-B-X-T-X-E-|-T-?-M---T-|-?-?---X-X-E-|-E-M-?-X---T-|-?-o-M-M-|-B-T-ME
E-M-E-T-o-|-|-E---T-X-B-|-?-T-E-M-|---M-|-?---M-M-M-M-o-M-B-|-X---|-?-?-?-o-X-o-T-?-M-T-M-E-E-X-M---|-E-|-?-E-E-T-o-X-T-?-X-|-?-T-X-T-|-?-T---?-X-o-?-|-o-B-X-M-M---o-B---T-X-T-o-?---E---o-M-|-E-?-X-BB
E-T-E-T-M-|-X-T-E-E-M-?-|-B-B-o-M-|-|-T-?-T-|-o-?-B-X-B-M-?-o-------o-?-B-o-X-T-|-|-M---|-?-|-T-E-E-T-M-?-X-M-|-X-X-|-M-o-X-M-E-o-?-E-?-|-B---B-----T-o-?-M-|-|-?-?-|-M-B-o-B-T-T-E-|-B-B-X-B-E-o-B-T-Mo
--o-E-o---T-B---X-o-T-|-?-T-o-X-o-?-B-E-T-|---M-?-E-B---X---X-?-X-B-o-E-o-T-B-T-o---X-X-B-o-M-|---M-B-T---o-E-M-T-T-X-T-T-X-E-E-E-E-|-M-?-?-M---E-E---M-M---T-o-E-|-T-?-E-B-?-M-B-o-E-o-|---X-E---M-o-T-
T---|-E-o-|-|---o-E-M-E-B-M-E-o-T-M---|-M-M-X-X-X-o-o-M-?-E-M-?-B---E-T---|-B-M-----T-o-B-M-T-B-E-?-?-?-|-M-B-----o-|-?-o-o-o-|-E---o-o-M-|-|---X-o-M-X---B---M-o-|-|-o-E-B-B---|-M-X-B---X-X-M-X-M-M--M
E-|-?-B-B-X-M-?---M---T-o-B-o-?-o-?-----E-E-T-X-E-B-T-|-?-E-T-T-M-T-M-|-E-|-E-T-E-|-E-X-o-E-o-----B---B-T-E-?-M---E---X-X-M-o-B-?-B-B---?---M-E-M-|-B-T-T-o-o-X---?-|---T-E-B-o-?---E-B-X-|-E-?-|-|---ME
m-T-T-o-?-B-?-X-?-?-T-|-?---B-X-E-?-o-E-M-M-T-?-B-B-E-B-----X-X-B-X-B-----?---?-X-B-T-?-X---X-B-o-?-E---o-E-M---o-M-X---B-M-E-E---E---M-E-o-E---M-?-B-B-|-M---?-M-?---|-B-o-?-T-X-T-|-M-?-B-B-B---E-?-?B
XXXXXXXXXXXXXXXXXXXXXXXXXXXXXXXXXXXXXXXXXXXXXXXXXXXXXXXXXXXXXXXXXXXXXXXXXXXXXXXXXXXXXXXXXXXXXXXXXXXXXXXXXXXXXXXXXXXXXXXXXXXXXXXXXXXXXXXXXXXXXXXXXXXXXXXXXXXXXXXXXXXXXXXXXXXXXXXXXXXXXXXXXXXXXXXXXXXXXXXX
