-E-?---X-o-E-M-M-?---|-X-B-X-T---|-X-X-E-|-o-M-E-T-?-|-o-X-B-M-X-E---X-o-E-B-B-|-?---M-B-M-T-M-X-B-X-M-?-B---B-X-?-o-X-M-X-o-E-E-|-T-E-|-M-|-T-|-M-o-|-M-M-X-X-X---?-E-o-o-X-E-T-B---M-?---?-E-E-E-?-o--
-?-M-M-M-E-o-X-T-o-?-X-E-M---M-o-E-|-?-X-o-?---M---B-T-T-o-E-o-|-X-E-?-E-o-B-M-M-T-M-E-o-M-B-T-o-E-|-?-o-o-o-B-?-|-X-B-B-T---M-X-?-T---?-X-T-|-o-o---B-T-?-M-B-T-o-B-o-M-|-E-E-o-?-X-|-|-B-?-X-M-|-X-X--
-?-M-T-M-T-X-X-----B-E---X-B-?-T-T-|-X-T-|-X-M-o-B-|-B-?-X-M-|-B-E-o-T-M-X-X-M-X-T-o---X-T-M-E-M-?-?-o-o-o-?-|-M-o-?-o-M-E-B-X-o-B-|-X-B-M-T-B---|-?-o-E-|-X-E-E-?-o-o-M-o-M-M-|-|-E-M-E-|-?-T-E-X-X----
-M-T-B-X-E-?-M-B-E---B-E-M-E-X-T-?-o-T-?-?-X---X---o-E-T-?-M-E-B-M-M-|-M-T-T-|-o-T-E-o-?-T-?-B-E-X---?-o-?-B-B-?-?---T-|-T-o-|-B-?-E-M-X-----M-----o-E-E-?-M-M-X-|---o-B-B-?---|-T-T-M-|-M-X-T-X-T-?-M--
-B-?-?-B-?-T---T-X---?-?---B-E-X-E-?---B-X-?-B-M-o-?-|-?-B-M-T-?-X-B-X-|-M-X-M-|-X-?-o-|-o-o-?-X-B-o-M-|-o-?-X-?-X-M-E-T-E-X-X-E-B-E-B---?-B-T-T---B-o-?-E---B-B-o-E-B-X-B-T-?-M-X-?---B-E-?-X-|-X-X-|--
-----M-M-|-X-B-T-|---T-o---?-T-E-|---E-T-----T-E-B-X-B-M-M-B---E---|-?-M---|-o---?-X-B-B-B-?-M-?---o-?---M-E-E-E---B-X-o-o-|-M-|-E-B-B-?-o-o-X-|-X-B-T-E-|-?-o-E-|-T-B-B-M---E-?-|-M-T-T-|-?-----M-M-|--
-----o-o-T-X-X-|-T-T-o-T-|---|-B-|-B-|-|-E-E-X---X-M-M-o-X-|-B-X-M-o-|-B-E-B-M-E-?-T-T-T-E-?-|-|-----B-?-T-?---|-|-T-E-|-o-T-o-M---o-X---X-B-E-M-o-T-|---X-B-X-M-o-X-X---T-E-E-E---o---X-----M-X-M-T-X--
-T-E-M---T-M-B-o-B-M-E---E-B-?-?-X---E-M-|-B-M-|-o-B-o-?-?-o-X-T-E-M---E-X-----T-?-M---?-E-E-B-T-E-B-E-E-|-B-M---E-E-?-?-T-E-o-?-X-|-X-T-E-M-T---X---M-o-E-?-o-M-E-B-o-?-o-X-B-?-M-T-o-?-M-M-T-M-T---B-v
-o-E-|-|---|-|---X-|-?-?-?-X-o-M---T-X---B-o-B-X-E-|-E-T-?-?-o-E---B-o-T-?-T---M-X-T---o-|-|-o-o-|-T-?-B-T-T-T-X-?---T-o-|-|-o-T---o-?-X-|-T-T-E-|-o-M-?---X-E-E-E-o-M-?-M-o-|-|-E-T-B-T---|-T-|-T-|-B-f
-E-o-E-B-|-o-----E-o-E-T-E-----T-?-X-o-T-o-?-M---|-X-B-E-M-X-B---M-M-?-o-T-X-|-B---?-o-M-M---|-B-M-B-o-E-X-X-M-M-T-?-X-B-|---X-o-M-T-E-M---E-----T-?-o-o-B-T-X-E-X-B-X-M-M-E-E-|-T-E-o-|-B-X-T-X-E-T-B-f
-------E-|-?-X-E-M-?---T-|-X-M-o-?-|-T-X-|-?-M-T---E-B-o-T-T-E-?---T-|-B-M-?-B-|-E-T-?---?-T-|-M-|-o-E-B-E-X-T-B-T-o-|-?-|-B-T-X-B-T-E-M-E-X-|-T-?-E-o-X-M-X---?-T-M-X-M-T-E-M-----T-?-X-M-?-X-o-o-B-|-f
---M-o-B-X-o---X-M-B-T---?-E-?-o-o-B-M-B-B-o-?-|-o-M-?-T-o-E-T-?-M-T-M-?-|-?-E-E-o-?-|-|-X-T-o-o-M-?-T-|-M-M-o-|---T-E-B-?-o-X-|-o-M-----T-o-E-T-E-?-o-T-B-X-?-T-M-|-X-B-o-E---o-|-o-|-E---M---?-X-|---f
-T-M-?---T-M-|-M-M-X-o-B-M-M-o-o-X---o-o-B-E-?-T-o---X-T-o-B-T-|-B-M-B-?-?---E---|-T-M-o-T-E---X-X-X-E---o-|-|-?-o-E-B-B-E---?-|-E-M-|-o-T-?-o-E-M-o-X-E-E---?-X-o-B-E-E-M---E-E-|---B-T-|-B-?-|-X-?-o-f
-o-?-E-o-----|-E-B-T-B-X-M---X-o-o-?-M-E-B-T-?-|---X-|-B-E-T-T-o-X-----T-M-X-------|-X-X-?-X-|-|---?-|-|-o-?---T-X-T-E-B-M-?-|-M-X-|-B---?-o-B-T-E-?-?-M-T-M-B-o-M-o-o-B-|-B-T---M-o-?-X-?-E-o-B-T-?-|-f
mX-|-E-o-B---B-B-X-o-o-o-|---|-|-o-B-?-T-B-B-B-X-M-M-B-T-X-M-T-|-o-X-B-X-E-M-M-T-T-E-X-|-E-T-B-M-|-M-o-|-X-X---T-?-?-E-M-B-o-o-?-?-M-E-E-E-?-B-|-E-T-B-B-X-X-o-?-o---B-E---X-|-o-?-M-E-o-?-T-?-o-|-T-T-X
XXXXXXXXXXXXXXXXXXXXXXXXXXXXXXXXXXXXXXXXXXXXXXXXXXXXXXXXXXXXXXXXXXXXXXXXXXXXXXXXXXXXXXXXXXXXXXXXXXXXXXXXXXXXXXXXXXXXXXXXXXXXXXXXXXXXXXXXXXXXXXXXXXXXXXXXXXXXXXXXXXXXXXXXXXXXXXXXXXXXXXXXXXXXXXXXXXXXXXXX
