?-o-E-X-o-E-X-B-B-X-X---?-|-T-o-M-M-o-B---X-T-?-o---o-X-E-?-E-M-o-?-?-M-|-|-|-M-E-B-E-X-T-M---o-B-T-X-X-X-o---|---o-X-B-M---o---|-X-B-M-M-T-E-?-?-E-B-E---?-T-X-E-?-|-M-?-X-X-M-E-B-T-?---?-|-X-T-X-o--X
B-B---E-o-B-E-o-M-M---E-o-B-B-?---|-E-|-X-M-|-X-M-M-E-E-|-?-X---M-T---T-o---B-T-X-o-B-E-|-T---|-?-T-E-B-X-|-E-E---X-M-o-M-B-|-X-T-M---T-T---X-?-T-o-o-T-B-E-M-|---o-X-M---?-T-E-M-X-|-?-B-B-T-M-?-T---T-
|-?-o-B-o-T-M-B-B-E-X-M-o---X-E-o-X-M-E---T-M-T-M---?-M---|-B-E-|-B-X-|-M-----|-T-|-E-B---M-o-E-E-T---M---M-M-|-|-X-|-E-T-X-o-M-----M-T-M-X-E-M-X-?-|-E-?-X-B---o---?-|-X-o-T---?-E-o-o-----|-M-?-T-|-BX
E-X-o-o---E-o-M-o-o-o-?-T-B-M-|-M-X---E-o-|-o-M-B-E-o-?-B-E-M-o-X-T-?-T-?-o-?-T-o-M-M-X-X-o-X---T---|-X-E-|-B---?-|-B-T---o-M-B-?-X-E-?-B-M-?-o-?---|-E-B---M-B---B-X-X-B---|-E-X-T-B-B-T-M-M-E-|-B-B-|X
----|-E-M-E-T-o---|---o---o-M---?-M-o-o-|-T-?-X---X-?-T-T-X---|-X---o-B-E-T-|-M-T-E-T---|-M-X-|-T-T-M---o-X-o-|-|-|---M-E-T-o-E-T-T---|-o-o---o-?---E-o-|-X-T-M-T-T-T-o-?-E-?-E-T---M-T-|-o-E-M-|-o-E-To
B-|-o-|-B-|-B-B-|-o-|-o-T-B-?-T-?---o-|-|-E-B-?---E-M-o-?-------T-M-B-?-o-o-T-?-T-|-o-?-X-|-o-T-o-o-o-B-X-T-X-B-E-o-E-X-E-M-X---T-X-B-E-B-M-E-X-?---?-o-E-M-o-E---o-E-B---B-o-T-o-M-o-M---X-|-E-o---E-oT
T-X---?-B-X-------o-T-X-|-o---|-?-?-T-E-?-M-E-B-T-?-X-B-?-M-o---?-E-o-E-B-T-|-X-B-o-|-X-X-M-|---M-|---|-T-B-T---E---------B-T-E-o-o-|-T-X-E---M-B-E-T-X-E-B-E-B---?---X-?-T-?---T-o-T-B-M-o-|-o-E-|-o-o-
o-X-|-?-o-M-T-M-?-B-B-T-X-T-B-X-M-E-M---T-o-B---?---M-X-X-B-o-E-?-?-M-?-B-T-o-?-|-o-?-?-X-M-?-T-|-X-X-X-T-M-?-o-M-T-M-?-|-M-B-E-M---|-T-|-M-B-T-B-----T-|-X-X---X-T---B-X-B-|---T-|-B-?---B-E-X-?-|-T-Ev
|-X-M-|-?---E-M-|-E-|-|-E-?-|-X-M-B-X-|---|-M-T-T-X-B-T-|-M-?-T-E-E-|-X-E-X-M-E---X---X-M-?-T-B-o-o-X-X-E-X---?-E-T-M-E-E-?-X---M-E-?-|-B-o-T-o-M-B-o-|-----E-o-E-B-X-?-X-B-M---M-X-E-M-M-E-B-M---|-B-?o
|-E---E-B-|-o-?-o-M-B-M-|-B-E-E-E-B-X-M-------M-E-T-?---X-?-o-|-B---|-B---X-M-X-|-E-|---o-B-E---M-M-?-|-B-?-M-o-X-M-?---M-M-B-?-o-X-M-|-|-o-o-X-E-?-B---o-X-|-E-?-|-o-T-o---M-|-?-|-E-T-E-E-o-M-X-E-E-XB
B---X-?-o-?-T-|-B-T-|-|-o-|-|-o-T-B-|-T-|-----T-X-|-|-M-o-X-?---T-o-X-?-T-E-X-M-B-X-o-?-B-E-X-M-T-o-M-T-|-?-o-?-E-B-o-E-?-?-M-|-?-B-T-E-M---|-T-?-o-B-|-X-X-M-E-M-o-M-T-o-X-|-?-M-|-|-X-----|-o-|---E-X-
o-T-E-?-E-X-M-B-o-X-T-E-E-------|-M-E-X-T-B-X-X-|-E-B-|-?-X---T-|-M-E-?-E-?-M-|-o-E-T---B-E---?---T-o-X---o-X-o-M---B-B-E-|-E-?-B-?-|---T-E-X-o-T-o-|-T-T-M-|-X-?-E-E-?-|-E-E-?-?-T-|---X-M-X-T-B-X-?-?X
M-M-T---X-|-o-?-o-?-B-X-X-E-M-?-E-E-o-T-B-B-B-X-o-B-B-B-M---|-X-|---B-B-T-|-X-?-B-T---T-|-E-?-B---B-o-E-o-o-E-M-B-o-B-T-M-o-E-T-E---X-|---B-X-M-T-?-X-|-E-E-X-o-T-T-?---B-M-E-M-X-E-X-?-M-X-|---o-X-M-?E
o-M---B-M-M-----X---X---E---o-?-X-X-X-|-T-|-M-B-o-?-M-X-B-?-E-X-T-X-o-B-B-M---o-X-B-|-X-?-|-?-B-?-X-----?---T-T-o-o-o-?-B-X---E-B-B-|-X-E-----E-?-o---E-?-?-B-X-o-E-E-M-E-o---E-X-E-M-X-E-T-B-B-?-T-?-TB
m-E---X-X-M-E-B---M-X-T-M-|-?-|-M-o-B-E-T-E-T-o-|-E-M-B-?-X---B-T-E-|-?-?-M-B-B-|-----X-M-E-|-E-M-M-?-B-o-T-B-?-o-E-o-o-|-M-o-E-o-X-o-o-X-E-o-X-M-|-|-T-T-X-T-M-T---X---M-|-M-X-?-o-?-T-----?-M-E-B-?-|X
XXXXXXXXXXXXXXXXXXXXXXXXXXXXXXXXXXXXXXXXXXXXXXXXXXXXXXXXXXXXXXXXXXXXXXXXXXXXXXXXXXXXXXXXXXXXXXXXXXXXXXXXXXXXXXXXXXXXXXXXXXXXXXXXXXXXXXXXXXXXXXXXXXXXXXXXXXXXXXXXXXXXXXXXXXXXXXXXXXXXXXXXXXXXXXXXXXXXXXXX
