X-E-|-o-X-T-o-?---T-?-?-M-o-o-X---T-B-E-o-E-o-B-B-E-T-|-T-X-X-E-?---X-B-B-E-X-?-E-T-M-?-X-E---?---M-?-M-o-X-?-B-o-|-X-X-T-B-E-o-B---E-E-|-o-M-o-o-?-?-?-T-|-T-B-?-T-M-?-|-X-B-E-E-|-B-X-E-?-X-B-T-X-T-?|
?-o---T-|-?-?-|-?---B-o-X---X-E-o-?-o-M-|-M-?-o-|---X-E-B-?-o-T-B-?-M-M-----M-E-E-?-X-------|-E-?-B-B---o-B-E-X-o-|-?-M-B-T-|-M-B-E-?-E-?-M-X-?-o-M-M-?---M-M-o---o-o-|-X---B-?-o-X-o-|---E-?-o-X-o-T-BB
o-|-X-M---o-|-X-M-X-B-o-o-M-X-B-E-T-o-B-?-|-?---E-o-E-?-|-?-M-?-T-|---?-M-?-o-M-?-E-o-o-M-B-o-T-E-----o-?-E-|-|-X-|-X-E-o-T-E-B-M-?---?-o-B---X-T-?-T-|-?---?-X-E-B-B-|-?-|-?-B-E-M-X---|-X-?---|-T-E-MX
--?---T-o-|---o-B-M-B-B-?-M-E-|-E-X-|-?-E-?-?-E-X-?-T---X---?-?---E-B-T-E-?-|-------|-X-o-M-X-T-E-|-?-B-M-M-B-|-T-E-B-E-?-E-M-B-o-B-M-T-T-o-T-M-T-o-E-|-X-M-E-|-E-o-E-M-?-E-X-X-E-T-E-B-M-T-|-E-|-X-B-o?
E-X-B-E-B-E-M-T-B-|-T-|-|-|-B-E-M-|---E-X---|-T-B-E---|-o-X-|-E-E-o-?-B-?-B-B-X-E-X-T-T-X-o-T-M-?-E-?-o-?-B-B-X-X-X-?-T---B---M-E---?-?-X-o-?---M-X-X-X-?-X-X-E-M-B-o-X---o-T-o-|-X-T-E-o-E---B-o-E-o-Xo
|-M-?---E-X-E-T---T-?-?-M-?-|-B-o-?-B-E-B-o-B-|-T-X-E---o-|-B-X-E-T-T-o-T-M-B-M-T---M---M-B-M-M-M-B-T-X-?-|-?-|-o-o-|-?-B-B-E-E-M-|-T-T-T-o-?-|-|-M-?-T-M-?-E---X-M-E-o---|-B-X-M-M-M---X-T-X-T-E-T-M-oX
o-T-B-M-B-M-|-?-B---o-----X-?-B-?---|-E-M-|-B---B-M-?-B-T-M-E-o-X-T-M-?-M-?-M-X-|-|-B-|---?-T-B-X-?-M-X-?---?-o-----X-|-|-|-X-M-|-T-B-o-E-?-E-|-T-E-T-?-?-|-|-X-|---E-o-o-M-X-o-o-X-?---X-|-?-X-T-?-o-X?
|-T-|-?-|---|-|-E-?-M---X-X---X-o-E-B-M-o-B-B-?-?-B-E-|-E-o-?-T-E-B-o-T-B-X-|-M-E-|-?-B-T-E-|-X-T-X-B---B-|-|-|-|-|---E-E-B-o-o-B-o---?-B-E-o-o-E-T---|-B-?-E-|-X-T-T-o-|-?-E-|-o---B-E-M-?-o-T-|-|-E-Xv
----o-|-M-o-o-T-X-|---X-E---o-M-X---E-E-E-----X-E-T-E-?-M-?-|-o-o---|-o-B-T-B-M-E-?-X-X-?---?-T-M-E-X-X-B-T-|-?-|-T-o-M-X-B-T-E-o-T-B-?-o-|-T-M-X-X-T-E-E-E-X-?-T-M-|-o-M-M-?-o-M-?-T-M-T---|-----?---M?
T---?-X-E-B-T---T-o-M-o-?-o-T-E-o-T-T-E-E-B-E-T-E-T-?-----M-o-B-E---X-X-B-B-o-X-M-E-B-B-E-X-|-B-B-B-o-M-o-B-X-X-E-X-M-M-B-B-----?-?-X-T-E-E-o-T-|-o-|-o-T-o-o-|-X-----T-X-?-X-X-B-B-T-B-X-E-o-o-?-?-T-??
M-E-o-T-B-E-|-M-|-B-B-o-T-o-T-?---E---E-o-E-o-E-o-o-B-X-B-B-o-T---|-M-T-E-o---?---B-X-M-X-B---T-|-E-E-T-|-|-o-E-T-M-B-M-B-T-B-M---T-T-M-o-B-E---E-M-B-X-?-X-?-E-o-?-T-|-?---?-?-T-B---E-X-E-?-M-?-B---?-
?-E-E-B-B-?-?-T-o-X-E-|-T-X-|-B-X-E-?-?---o-B-B-X-B---E-E---E-T-T-?-|-o-?---o-X-X-?-M-o-|-X-M---|-E-M-B-E-M-X---o-B-|-?-|-o-?-B-E-|-B-o-T-|-|-X-X-|-M-T-X-?-?-|-?-B-|-T-E-M-B---X-E-B-B---|---X-M---?-X|
E-X-B-?---E-o-E-X---T-|-o-o-T-E-|-E-o-|-B---B-T-B-B-?-|-?-T-o-E-o-o-M-T-|-M-E-M---E-o-?-M-X-o-M-o-B-T-?---|-o-B-|-|-T-B-|---B-T-T-X-B-X-M-B-B-o---T-E-E---B-X-T-M-M-X-E-?---T-o-?-|-|-M-B---o-o-X-o-|-Mo
o-E-X-T-X-B-E-o-|-|---?-X-M---|---X-M-|---|-T---M-o---M-?-?-B-X-|-E-E-?-E---?-o-o-o-T-o-B-|-B-M-|-o-E-M---M-o-|-X-T-M-T-?-M-B-----M-T-?-B-E-o-E-E-o-E-X-M-|-X-M-?-o---X-T---T-M-B-?-T-E-o-T-?-B-|-B-T-|B
m-B---M---X-|-M-o-T-o-T-M-T-M-M-E---?-B-----M-X-|-M-B-o-T-?-E-M-B-E-B-----E-o---T-T---o-o-T-|-B-M-?-T-E-E-B-o-B-?-E-o-?-T-B-?-X-E-E-X---|-|-M-E-X-X-?---M-B---B-M---B-o-?-M-B-X---T---E-?-E-B-o-E-B---XE
XXXXXXXXXXXXXXXXXXXXXXXXXXXXXXXXXXXXXXXXXXXXXXXXXXXXXXXXXXXXXXXXXXXXXXXXXXXXXXXXXXXXXXXXXXXXXXXXXXXXXXXXXXXXXXXXXXXXXXXXXXXXXXXXXXXXXXXXXXXXXXXXXXXXXXXXXXXXXXXXXXXXXXXXXXXXXXXXXXXXXXXXXXXXXXXXXXXXXXXX
