-o-M-X---?---B-o-|-?-o-B-?-B-M-X-?-E-T-|-o-E-?-B-T---E-B-?-M-M---T-|-E---X-M-B-o-o-?-B-M---E-T-T-M-o---X-|-o-T-X-M-|---?-T-B-E-X-M-X-|-o-|-M-T-M-o-B-|-B-?-B-E---X-|-o-|-B-X-?-E-?-?---M-|-?-X-|-o---?--
-?-B-B-|-T-M-|-E-T-?-T-o-B-X-B-|-B-E-o-T-o-X-T-T-----B-?-|-|-E-T-M-M-M-E-M-T-o-E-o-X-?-B-T-B-|-|-E-?-M-?-X---T-B-?-?-|-o-X-M-o---X-M---T-X---?-?-o-o-B-E-T-o-?-B-E-?-o-T-T-T-o-E-E-o-o-M-E-X-T-?-M-E-?--
-X-X-|-o---T-o-T-E-?---|-o-o-o-o-?-|-E-M---B-X-B-E-E-X---T-X-M-?-T-B-?-o-?-|-?-E-|-T-B-E-E-M-|-?-|-B-E---X-?---X-X-|-?-X-X-----B-o-?---X-M-M-|-o---T-M-|-o-X-o-T-E-E-T-o-E-o-?-|-X-o-B-X-T-?-T-?-E-E-M--
-X-T-|-?-?-E-M-B-B-B-M-T-T-|-M-T-M-T-M-M-B-M-M-|-?-o-|---T-----|-B-|-o-?-M-|-o---o-B-o-o-M-T-X-E-T-X-B-|-o---?-o-T---T-|-M-o-|-E-E-E-X---o-M-o-B-T-|-E-?---M-|-?-B-?-|-?-----o-T-o-T---X-T-o-|-M-o-T-E--
-o-E-|-T-E---X-X-X-|-M-M-X-T---E-|-M-E-B-M-----X-|---o-T-X---o-E---o-M-B-o-|-M-X-B-?-|-M-X-X---E-M---o-X-o-M-T-o-X-M-o-E-B-M-T-?-?-X-o-T-M-o---B-M-o-B-M-M-o---|-E-B-T---X-o-E-X-B-o-B-X-E-M-?-T-M-X-E--
-?-B-B-E-M-E-o-B-?-E-E-B-X-o-o-M-M-o-T-o-E-----T-E-o-M-T-E-o---M-----?-M-?-?-B-T-E---M-E-X---|-T-E-o-T-E-T-E-B-|-o-X-E---|-o-E-B-o-X-T---M-E-o-|-|-o-T-|-o-o-B-o---T-X-o-o-o-?-X-?-|---?-|---X-T---?-T--
-?-E-o-T---|-|-E-B-M-o-M-o-o-|-o---M-|-?-X-E-|-o-E-E-M-|---M-M-M-o-o-T-B-?-o-T-X-E-|-?-X-M-M-|---?-o-o-o-X-|-M-E-o-B-T-B-E-T-E---o-|-B-?---?-B-M-|-X-B-T-M-T---?-X-B-X-X-M-o-B-T-X-?-X-o-X-E-T---?-?-B--
-E-E-o-?-X-o-T-B-X---|-X-----B-X-M-T-E-X-E-X-T-M-M-?-X-B-o-B-o-B-T-?---E-B-M-E-X-o-X-|-M-E-|-|-M-M-X-B---X---T-o-o-T-E-E-?---X-E-M-|---E-M-E-E-?-B-M-o-o-M-o-M---?-X---E-|-?-|-o-o-B-o-T-E-?-T-B-X---B-v
-B-T-M-o-?-B-M-M---E-E-X-X-M-|-M---o-X---E-M-X-?-B-M-?---T-o-X-M-E-|-E-X-X-?-|-B-o-T-|-B-T-M-E-X-T-o-X-|-T-X-|-|---T-o-?-----?-?-T-?-?-|-M-|-T-B-M-?-M-X-B-M-|-|-?---E-?-E-X-B-o-o-|-T-E-B-M---X-|-B-T-f
-?-T-M---X-|-T-T-|-X-o-B-M-M-o-?-?-M---X-o-|---X-|-B-E-M-T-|-X-B-?-T-E-B-E-|-M-M-?-|-?-?-?-o-o---T-o---E-T-T-M-?-----|-X-E-|-E-M-T-E---?-T---E---T-X-X-M---o-M-M-E-o-X-B-o-M---M-B-T-?-E-E-E-T-M-B-B-?-f
-?-|-T---X-o-E-E-X-?-M-|-M-M-M-|-o-?---o-|-|---M-B-?-B-|-o-X-o-X-E-?-?---B---B-M---X-E-B-|-?-X-X-|-T-E-E---X-M-|-E-M-B-E-B---E-B-o-E-?-|---M-E-B-X-X-|-B---X-B-B-?-T-E-E-?-X-M-o-M-B---B-X-T-?-?-B-?-X-f
-M-X-?-|---B-o-|-M-E-T-|-o-E-M-X-E-?-T---B-E-M-E-o-o---?-T-?-o-o-M-?-T-B---|-E-X-E-|---X---?-M-M---|-B-|---o-|-|-o---?-B-X---E-?-o-?---o-?-E-o-?-o-E---B-E-M-B-X-M-|-|-T-T-X-E-T-B-T-B-X---?-B-T-E-o-T-f
-?-M-o-?-o-T-X-?-M-X-X-T-|-?-B-?-|-|---M-T-M-E-o-T-X-B-T-?-|-M-o-T-?-X-E-?-M---o-X-X-B-?-B-T-?-E-X-T-M-B-E-T-o-X-B-T-?-o-B---X-T-E-?-T-?-M-|-o-|-M-|-o-M-T-o-B-|---?---o-B-B-M-M-M-?-X-T-M-o-o-T-T-T-M-f
-T-T-|-?-?-E-X-|---X-M-E-|-X-o-M---T-M---?-X-X-|-M-M-M-M-?-E-|-o---M-o-o-M-E-o-?-?-X-M---X-o-o-?-M-X-T-M-o-M---M-|-|---T-?-?-T-|-X-?-|-o-?-X-?-B-T---E-X---M-E-?-?-B-X---|---?-E-B-X-o-T-o-?---M-B-X-X-f
m--M-T-T-M-|-X-B-M-T-E---?-E---B-o-M-X-T-E-X-o-M-X-T-T-M-?-o-T-E---X---|-X-?-B-M-E-M-B-B-E---T-M-E-|-X-E-|-?-M-|-M---?-o---M-X---T-E---M-E-B-E-o---T-|-M-E-B-E---o-|-o-?-?-?---M-?-o-o-E-|-T---E-----B-X
XXXXXXXXXXXXXXXXXXXXXXXXXXXXXXXXXXXXXXXXXXXXXXXXXXXXXXXXXXXXXXXXXXXXXXXXXXXXXXXXXXXXXXXXXXXXXXXXXXXXXXXXXXXXXXXXXXXXXXXXXXXXXXXXXXXXXXXXXXXXXXXXXXXXXXXXXXXXXXXXXXXXXXXXXXXXXXXXXXXXXXXXXXXXXXXXXXXXXXXX
