T-T-B-M-B-T-B-B-?---o-T-?-?-X-T-B-E-E-|-T-B-M-o---|-|-----E---X-B-?---o-M-----E-M-M---|-o-o-T-E-o-B-----o-X-?-B-|-E---X-X-M-o-o-X-?-?-o-T-X---o-X-B-X-T-B---o-o-o-E---|-M-M-M-?-B-|-E-o-?---M-T-B-o-X-T-
o-|-E-B-M---E-X-M-E-B-T-|-T-T-T---E-X-o-B-T-B-B-E-X-M-X---?-E-X-|-|-?-o-o-E-B-X-M---|-B-|-M-|---X-T---X-?-B-X-X-|-|-?-B-?-B-E-|-M-T-o-X-E-o-E-M-B-o-M-E-M-E-B-E-M-----?-?-B-M-|-X-T-----o---X-X-X-?-T-E|
M-T---|-M-o-|-E---?-|-?-?-T-M-o-E-X---T-M---X-E-T-X-M-o-M-|-B-------M-?-T-X-T-E-E-|-T-o-o-B-o-?-|-|-M-B-|-T-?-M-?-?-T-M-M-X-?---E-|-E-E-X-|-M-X-|-E-o---E-M-B-E---o-E-M-X---X-E-M---|-B-M-?-o-o---X-E-E-
B-X-|-M-M-M---|-|-|-E-M-B-X-B-T---?---E-?---E-E-E-o-E---|-o-T-E---B-B-E-E-M-B-T-E-X-X-o-E-B-M-?-E-B---B---?-E-E-|-X-M-|---o-T-B-o-o-E-?-E-?-T---M-|---|---E-|-|-B-?-E---X-----E-|-?-|-X-B-?-o---E-B-o-X-
X-B-|-|-E-X---?-?-B-E-M-o-X-B-E-o-B-E-?-E-?-o-o-|-o-?-T-T---X-?-B-X-|-?-?-B---|-o-E-E-E-X-o-|-B-o-T-B-o-?---T-E-o---X-?-o-E-X-|-|-E-?-E-E-M-X-M-M-|---?-X-?-X-B-X-X-X-X---o-T-?-B-X-X-E-E-B-B-|-M-E-B-?M
--B-B-?-|-X-X-T-?-B-T---T-X-o-?-X-?-B-E-?-o-B-|-X---M-o-B-E-X-X---M-M-X-M-B-B-B-|-o-?-B-X-|-M-X-T-?-B-M-T-B-T-M-|-o-E---E-B-o---B-B-o-B-|-E-|---|-M-X-B-T-M---o-o-M-E-T-M-E-M-|-E-?-B-E-T-|-?-o-E-o-B-M-
|-----|-T---?-M-?-B-M---M-E-?-M-M-B-T-|-E-|-T-?---?---?-o-B---X-X-E-X-|-|-o-X-E---|-B-E-?-T-o-|-----B-T-?-o-o-|-T-X-T-T-|-M---E---o-E---?-E---|-?-X-M-M-M-X-M-E-B---o-T-?-|-X-T-T-E-E-X-M-T-M-E-B-E-|-BE
B-M-E-T-X-X---?-T-M-?---M-E-o-|-?-o-M-|-E-M---|---B-o-B-o-T-|-B-o---?-|-B-|-|---M-|-B-X-o---|-E-?-X-?-E-M-T-M-o-B-X-?-X---E-o-?-T-?-o-X-T---B-M-E-E-M-?-E-?-B-E-B-o-|-o-M-B-|---M-?-E-o-?-E-M-X-E-B-B-Xv
o-?-B-X-o-E-?-?-o---X-X-o-X-o-o-T-M-X-M-?---|-o-o---E---B-o-|-T-o-T---X-X-?-M-X-T-?-?-E-T-|-?-B-?-X---|-X-?-X-X-|-B---T-B-o-T-T-M-o-M-B-X-E-M-E-M-E-o-M-?---X-----?-|-o-B-o-B-X-T-|-X-|-?-|-M-?-X---M--E
X-E-?-----B-B-o-o-M-X-o-X-T-M-E---M-E---o-X-X-B-B-|-?-o-M-o-X-E---B-B-M-M-M-|-?-M-T-E-T-E---T-X-X-|-X---B-E-X-?-?-|-|---o-----E-B-T---T-E-?---M-o-B-o-B-E-?-X-T-B-X-B-?-T-M-B-o-----|-M-E-?-E-M-X---B-|T
?-M-B-E-T-M-M-T-T-E-o-T-|-M-?-E-o-|-?-?-|-E-E-?-|-|-o---?-o-E-?-E-T-T-o-T-M-B-o-M-o-o-----o---T---M-X-T-B-|-B-T-o-E---o-T-M-E-X-B-T-o-?-o-o-X-E-B-X-M-?---o-B---X-E-|---o-|-M-T-T-----?-|-E-M-T-|-B-B-ME
--T-E-T-|-B-?-|-|---M-T-M-E-o-B-?-|-T-?-X-o-M-?-X-B-o-o-M-X-E-?-----?-T-o---B-o-|-?-?-?-X---T-M-E-M-|-M-M-T-M-|-X-E-?-T-?-X-E-B-o-E-B-o-o-o-E-o-o-?---E-M-o-M-?-o-M-B-X-E-|-o-B-o-|-|---o-X-B-M---X-X-ET
X-?-T-X---?-X-M-B-o-E-?-o-M---X-o-M-o-T-E-M-o-T-o---|---B-X-E-?-B-T-|---|-X-o-E-?-M-B-E-M---X-----|-|-----X-E---|-|-B-T-|-?-M-|-X-o-M-M-o-B-E-X-M-T-----X-|-M-E-X-X-o---M-----T-T-E-E-E-M-o-M-|-?---o-E-
o-o-o-|---|-B-T---B-o-X-E-E-B-|-M-o---E-T-E-T-?-|-M-o---B-M-o-M---?-B-E-T-M-M-?-E-E-M-T-?-M-E-X-X-----o-?-B-B-T-|-T-T-o-|-|-o-?---o-T-?-X-o-B-|-T-X-B-T-E-|-X-X-B---|-|-M-E-T-?-B-?-X-B-X-o-|-B-M---?-BT
m-?-B---|-X-|-M-o-|-M-o-o-M-?-M-T-T-o-o-E-?-E-?-T-M---T-?-|-B---B-B-B-|-T---T-?-o-B-o-o-?-T---?-B-B-X-o-X-|-|-X-o-o-X-o-X---M-B-?-T-----|-M-E---?-T-B-o-T-X-|-X-X-E-?-?-|-|-?-E-B-o-?-o-E-T-o-|-E-|-X-X|
XXXXXXXXXXXXXXXXXXXXXXXXXXXXXXXXXXXXXXXXXXXXXXXXXXXXXXXXXXXXXXXXXXXXXXXXXXXXXXXXXXXXXXXXXXXXXXXXXXXXXXXXXXXXXXXXXXXXXXXXXXXXXXXXXXXXXXXXXXXXXXXXXXXXXXXXXXXXXXXXXXXXXXXXXXXXXXXXXXXXXXXXXXXXXXXXXXXXXXXX
