T-T-X-|-E---o-|-E---E-M-|-M-B-E-T---?-B-o-T-T---B-----X-|-?-M---?-X-?-B-B---?-B-B-X-B---M-B-T-E-B-B-X-E---E-?-T-X---?-o---o-B-T-X-E-?-T-o-E-|-B-?-|-?-E-o-B-B-?---X-B-B-o-?---o-|-E-B-|-X-E-|-|---o-?--M
T-o-B-T-B-X-o-E-T-X---X-|-E-T-T-?-----o-?---?---X---E-?-M-E-E---E-|-?-T-o-T-o-|-|-M-E-T-|-B-B-M-|-|-|---|-B-M-X-E-E-|-M-|-T-M-M-E-|-M-M-M-T-T-X-|-B-T---E-o-E-M-E-M-M-X-|-?-B-o-?---E-----?-M-X-X-X-B-?-
B-o-M-X-|-?-|-T-o-o-X-|-B-|-E-|-|-M-E-|-E-|-E-X-X-X-?-|-M-X-X-X-E-?---o-|-X-M-?-?-?-B-o-o-E-M-E---X-?-?---B-T-T-M-M-?-|-|-?---o-X-X-E-?-E-E-X-?-X-?-o-M-o-B-T-o-T-X-T-X-M-?-?---|-T-|-o-----E-B-X-M-|-?E
B-T-|-|-?-T-?-|-?-|-T-B-M-o-|-M-|-|-X---o-X-X-o-?-E-o---M-M---E-M-?-E-|-X-B-|-X-X-o-|-o-B-|-?-B-T-T-o-M-o-E-|-B---|-B-B-T---o---|-o-B-B---T-M-o-E-X-?-M-B---X-?-M-E-B-E-T---E-M-E-M-T-M-|-|-?-X---?-B--T
T---?-E-M-B-B-T---T-M-T-B-M-T-E-T-M-?-E-E-E-o-X---X-----E-M-|---B-X-E-T-M-|-----T-B-o-|-?-B-M-?-----B-E-X-?-X---X-?-o---M-M-?-o-T-E-T-|-o---M-B-M-|-M-?-o-M-o-E-o-E-o-?-M-X-X-X-X-|-M-?-M-E-o-----?-?-?o
B-X-M-B-T---|-B-|-X-B-o-T-o-B-X-M-?-|-o-M-B-M-E-T-T---o-o-|-|-E-o-E-o-X-o-|-o---X-B-B-X-M-|-X-B-B-o-M-E-o-T-M---M-E-o-o-E-M-M-?-?-X---|-T-E-?-E-?-|-?-X-M-T-B-B-M-X-X-T-B-E-?-|-o-?---X-T---X-o-?-T-M-??
B-|-X-T-B-M-T-o-o-o-E-?-?-B-E-|-o-T-T-?-?-X-|-|-?---B-|-B-E-M-|-M-M-T-M-o-o-T-X-B-o-M-?-o-M-X---X-?-?-T---T-o---T-B---X-o---T-?-o-B-?-o-M-T-?-T-o-o-M-T-E-X-?-o-M-T-T-T-|-M---T-?-o-B-?-T-|-|---o-|-B--?
o-?---T-X-?-o-?-B---M-X-E-X-?-T-o-?-M-?-o-?-|-?-E-T-?---B-o-X-X-B-T---E---?-o-T-E-B-E-M-B-M-?-|-o---E-B-X-o-M-T-E-X-o-|-B-|---E-E-B-X-T-X-o-M-|-M-T---B-E-X-T-|-o-o---B-o-?-M---B-|-?-|-T-E-M-o---M---Ev
?---E-T-T-T-M-T-M-|-T---|-T-M-E-T---T-o-o---o-E-X-X-B-o-E-o-X-----M-E-o-o-?-X-T-E-?-|-T-o-?-o-T---M-|-?-|-|-M-X-o-E-M---X-E-o-E-?-E-M-T---?-?-M-E-X-o-B-M-T-X-?-T-E-B-T-T-B-M-o-E-o-?-E-E-E---M-B-?-E---
E-X-E-T-M-|-E-X-E-o-X---E-o-o-E-X-o---M-M-|-B-M-X-?-M---T-X-E-?-X-E-E-?-X---|-|---o-E-X---B-B-?-E-B-|-?---M-E-M-T-X-E-B-M-|-T---T-?---B-T-M-|-X-M-T---T-|-X-o-T-o-E-M-E-E-E-T-|---T-T-B-|-o-B-M-?-B-E-|T
o-T-o-|-|-o-B-X-B-?-T-M-E-|-T---X-|-M-T-M-E-M---M-?---|-E-E-o-E-M-E-E-B-B-?-E-o-X-X-E-T---B-o-E---?-B-X-o-M---|-T-B-X-B---|-|-E-T-X-X-E-B-|-B-X-B-M-o-?-E-?-T-X-X-------|-E---E-E-o-M-X-E-M-B-----T-o-Eo
?-?-M---M-|-|-?-X-|-T-T-T-M-B-M-B-B-o-?-T-o---E-E-T-?-o-|-M-X---E-?-B-E-?-E-o-B-M-|-|-T-----E-E-T-?---B-?-M-E-B-M-E-X-B-?-T-E-T-B-M-o-|-M-B---?-M-|-o-B-E-|-|---X-B-M-o-o-M-T-?-M-T-X-M-T-B-T-E-?-|-?-TE
o---?-E-E-B-|-?-o-B-o-X-|-|-T-o-?-------E-M-o-E-T-X-E-B-M-|-o-?-o-?-B---T-B-|-X-|-E-|-?-X-|-|-E-|-M---B-T-E-B-M---T---B-?-?-o-o-?-B-E-o-E-M-o-?-B-|-T-?-T-E-X-o---|-|-?-?-T-o-?-E-o-----E-|-X-o-M-o---o-
M-o-B-B-?---E-|-E-E-|-----?-B-E---o-|-M-B-B-M-X-|-|-X-|-B-M-X---o-M-M-X-E-B-E---E-?---X-o-|-X-T-E---|-?-o-T-o-?-X---X-o-?-T---?---T-T-T-|-X-o-?-X-?-T-T-B-o---E-X-o-T-o-|-?-M---?-X-?-B-T-?-o-?-|-X-M-B-
m---B-T-B-|-?-?-B-----o-X-X---?-X-T-|-X-|-T-E-|-X-|-o-|-|-B-X---M-T-T-|-B-|-o-B-|-T-B---?-X---X-B-|---?-?---|---M-|-M-X---B-|-T-?-E-|-o-o-T-E---T-T-M-E-o-?-B-M-|-E-B-|-B-----X-M-E-T-E-M-B-|-X-T---M-TE
XXXXXXXXXXXXXXXXXXXXXXXXXXXXXXXXXXXXXXXXXXXXXXXXXXXXXXXXXXXXXXXXXXXXXXXXXXXXXXXXXXXXXXXXXXXXXXXXXXXXXXXXXXXXXXXXXXXXXXXXXXXXXXXXXXXXXXXXXXXXXXXXXXXXXXXXXXXXXXXXXXXXXXXXXXXXXXXXXXXXXXXXXXXXXXXXXXXXXXXX
